05 05 05 05 05 05 05 05 05 05 05 05 05 05 05 05 05 05 05 05 05 05 05 05 05 05 05 05 05 05 05 05 05 05 05 05 05 05 05 05 05 05 05 05 05 05 05 05 05 05
05 05 05 05 05 05 05 05 05 05 05 05 05 05 05 05 05 05 05 05 05 05 05 05 05 05 05 05 05 05 05 05 05 05 05 05 05 05 05 05 05 05 05 05 05 05 05 05 05 05
05 05 05 05 05 05 05 05 05 05 05 05 05 05 05 05 05 05 05 05 05 05 05 05 05 05 05 05 05 05 05 05 05 05 05 05 05 05 05 05 05 05 05 05 05 05 05 05 05 05
05 05 05 05 05 05 05 05 05 05 05 05 05 05 05 05 05 05 05 05 05 05 05 05 05 05 05 05 05 05 05 05 05 05 05 05 05 05 05 05 05 05 05 05 05 05 05 05 05 05
05 05 05 05 05 05 05 05 05 05 05 05 05 05 05 05 05 05 05 05 05 05 05 05 05 05 05 05 05 05 05 05 05 05 05 05 05 05 05 05 05 05 05 05 05 05 05 05 05 05
05 05 05 05 05 05 05 05 05 05 10 08 08 08 08 08 08 08 08 08 08 08 08 08 08 08 08 11 05 05 05 10 08 08 08 08 11 05 05 05 05 05 05 05 05 05 05 05 05 05
05 05 05 05 05 05 05 05 05 10 09 00 00 00 00 00 00 00 00 00 00 00 00 00 00 00 00 07 08 11 05 06 00 00 00 00 07 08 11 05 05 05 05 05 05 05 05 05 05 05
05 05 05 05 05 05 05 05 05 06 00 00 00 00 14 00 00 00 14 00 00 00 00 00 01 03 00 00 00 07 11 06 00 00 00 00 00 00 07 11 05 05 05 05 05 05 05 05 05 05
05 05 05 05 05 05 05 05 05 06 00 00 00 22 25 00 00 00 24 23 00 00 00 01 13 06 00 00 00 00 04 06 00 00 00 00 00 00 00 04 05 05 05 05 05 05 05 05 05 05
05 05 05 05 05 05 05 05 05 06 00 48 00 20 00 00 00 00 00 20 00 00 22 37 08 33 23 00 00 00 07 35 00 00 00 00 00 00 00 07 11 05 05 05 05 05 05 05 05 05
05 05 05 05 05 05 05 05 05 12 02 02 02 31 00 00 00 00 00 36 02 02 31 00 00 00 20 00 00 00 00 18 00 21 00 00 00 00 00 00 04 05 05 05 05 05 05 05 05 05
05 05 05 05 05 05 05 05 05 05 05 05 05 12 02 02 02 02 02 13 05 05 44 19 17 00 20 00 00 00 00 00 00 00 00 00 00 00 21 00 04 05 05 05 05 05 05 05 05 05
05 05 05 05 05 05 05 05 05 05 05 05 05 10 08 08 08 08 08 08 08 11 06 00 00 00 20 00 00 00 00 00 00 21 00 00 00 00 00 00 04 05 05 05 05 05 05 05 05 05
05 05 05 05 05 05 05 05 05 05 05 10 08 09 00 00 00 00 00 00 00 04 06 00 15 19 25 00 00 00 00 14 00 00 00 00 00 21 00 00 04 05 05 05 05 05 05 05 05 05
05 05 05 05 05 05 05 05 05 05 10 09 00 00 00 00 00 00 14 00 00 04 06 00 00 00 00 00 00 00 00 20 00 21 00 00 00 00 00 00 04 05 05 05 05 05 05 05 05 05
05 05 05 05 05 05 05 05 05 05 06 00 00 00 00 00 00 01 31 00 00 04 12 02 02 02 02 03 00 00 00 20 00 00 00 00 21 00 00 00 04 05 05 05 05 05 05 05 05 05
05 05 05 05 05 05 05 05 05 10 09 00 00 00 00 00 00 04 06 00 00 04 05 10 08 08 11 06 00 00 00 20 00 00 00 00 00 00 00 00 04 05 05 05 05 05 05 05 05 05
05 05 05 05 05 05 05 05 05 06 00 00 00 00 00 00 00 04 06 00 00 07 08 09 00 00 07 38 02 02 02 46 02 02 02 02 34 17 00 00 04 05 05 05 05 05 05 05 05 05
05 05 05 05 05 05 05 05 05 06 00 00 00 00 01 02 02 13 06 00 00 00 00 00 00 00 00 07 11 05 05 05 05 05 05 10 09 00 00 01 13 05 05 05 05 05 05 05 05 05
05 05 05 05 05 05 05 05 05 06 00 00 00 00 07 08 08 08 09 00 00 01 03 00 00 00 00 00 07 08 08 45 08 08 08 09 00 00 01 13 05 05 05 05 05 05 05 05 05 05
05 05 05 05 05 05 05 05 05 06 00 00 14 00 00 00 00 00 00 00 00 04 12 02 02 02 03 00 00 00 00 18 00 00 00 00 00 01 13 05 05 05 05 05 05 05 05 05 05 05
05 05 05 05 05 05 05 05 05 06 00 00 36 02 02 02 02 02 02 02 02 13 05 05 05 05 06 00 15 17 00 00 00 15 17 00 01 13 05 05 05 05 05 05 05 05 05 05 05 05
05 05 05 05 05 05 05 05 05 06 00 00 04 10 08 08 08 08 08 08 08 11 05 05 05 05 06 00 00 00 00 00 00 00 00 00 04 05 05 05 05 05 05 05 05 05 05 05 05 05
05 05 05 05 05 05 05 05 05 06 00 00 04 06 00 00 00 00 00 00 00 04 05 05 05 05 06 00 00 00 00 00 00 00 00 00 04 05 05 05 05 05 05 05 05 05 05 05 05 05
05 05 05 05 05 05 05 05 05 06 00 00 04 06 00 01 03 00 00 00 00 04 05 05 05 05 06 00 00 00 00 00 00 00 00 00 04 05 05 05 05 05 05 05 05 05 05 05 05 05
05 05 05 05 05 05 05 05 05 06 00 00 04 06 00 04 44 17 00 00 00 04 05 05 05 05 12 02 02 02 02 02 02 02 02 02 13 05 05 05 05 05 05 05 05 05 05 05 05 05
05 05 05 05 05 05 05 05 05 06 00 00 04 06 00 04 06 00 00 21 00 04 10 08 08 08 08 08 08 08 08 08 08 08 08 08 11 05 05 05 05 05 05 05 05 05 05 05 05 05
05 05 05 05 05 05 05 05 05 06 00 00 04 06 00 04 06 00 00 00 00 04 06 00 00 00 00 00 00 00 00 00 00 00 00 00 07 08 11 05 05 05 05 05 05 05 05 05 05 05
05 05 05 05 05 05 05 05 05 06 00 00 07 09 00 04 06 00 00 14 00 04 06 00 01 03 00 00 00 00 00 00 00 00 00 00 00 00 07 11 05 05 05 05 05 05 05 05 05 05
05 05 05 05 05 05 05 05 05 06 00 00 00 00 00 04 06 00 01 46 02 13 06 00 04 06 00 21 00 00 00 00 00 00 00 00 00 00 00 04 05 05 05 05 05 05 05 05 05 05
05 05 05 05 05 05 05 05 05 06 00 00 14 00 00 04 06 00 07 08 08 08 09 00 04 06 00 00 00 00 00 21 00 21 00 00 00 00 00 07 11 05 05 05 05 05 05 05 05 05
05 05 05 05 05 05 05 05 05 06 00 00 20 00 00 04 06 00 00 00 00 00 00 00 04 06 00 00 00 00 00 00 00 00 00 14 00 00 00 00 04 05 05 05 05 05 05 05 05 05
05 05 05 05 05 05 05 05 05 12 02 02 46 02 02 13 12 02 02 02 02 02 02 02 13 12 02 02 02 02 02 02 02 02 02 46 03 00 00 00 04 05 05 05 05 05 05 05 05 05
05 05 05 05 05 05 05 05 05 05 05 05 05 10 08 08 08 08 08 08 08 08 08 08 08 08 08 08 08 08 08 08 08 08 08 08 33 17 00 00 04 05 05 05 05 05 05 05 05 05
05 05 05 05 05 05 05 05 05 05 05 10 08 09 00 00 00 00 00 00 00 00 00 00 00 00 00 00 00 00 00 00 00 00 00 00 00 00 00 01 13 05 05 05 05 05 05 05 05 05
05 05 05 05 05 05 05 05 05 05 10 09 00 00 00 00 00 00 00 00 00 00 00 00 00 00 00 00 00 00 00 00 00 00 00 00 00 00 01 13 05 05 05 05 05 05 05 05 05 05
05 05 05 05 05 05 05 05 05 05 06 00 00 00 00 00 00 00 00 00 00 00 00 00 00 00 00 00 00 00 00 00 00 00 00 00 00 15 47 05 05 05 05 05 05 05 05 05 05 05
05 05 05 05 05 05 05 05 05 10 09 00 00 00 00 00 00 00 00 00 00 00 00 00 00 00 00 00 00 00 00 00 00 00 00 21 00 00 07 11 05 05 05 05 05 05 05 05 05 05
05 05 05 05 05 05 05 05 05 06 00 00 00 00 00 00 00 00 00 00 00 00 00 00 00 00 00 00 00 00 00 00 00 00 00 00 00 00 00 07 11 05 05 05 05 05 05 05 05 05
05 05 05 05 05 05 05 05 05 06 00 00 00 00 00 00 00 00 00 00 00 00 00 00 00 00 00 00 00 00 00 00 00 21 00 00 00 00 00 00 04 05 05 05 05 05 05 05 05 05
05 05 05 05 05 05 05 05 05 06 00 00 00 00 00 00 00 00 00 00 00 00 00 00 00 00 00 00 14 00 00 21 00 00 00 00 00 00 00 00 04 05 05 05 05 05 05 05 05 05
05 05 05 05 05 05 05 05 05 06 00 00 00 00 00 00 00 00 00 00 00 00 01 03 00 00 00 01 31 00 00 00 00 00 00 00 00 00 00 00 04 05 05 05 05 05 05 05 05 05
05 05 05 05 05 05 05 05 05 06 00 00 00 00 00 21 00 14 00 00 00 00 04 06 00 00 15 37 09 00 00 00 00 00 00 00 00 00 00 00 04 05 05 05 05 05 05 05 05 05
05 05 05 05 05 05 05 05 05 06 00 00 00 14 00 00 00 36 03 00 00 00 04 12 03 00 00 00 00 00 00 00 00 00 00 00 00 00 00 00 04 05 05 05 05 05 05 05 05 05
05 05 05 05 05 05 05 05 05 12 02 02 02 46 02 02 02 13 12 02 02 02 13 05 12 02 02 02 02 02 02 02 02 02 02 02 02 02 02 02 13 05 05 05 05 05 05 05 05 05
05 05 05 05 05 05 05 05 05 05 05 05 05 05 05 05 05 05 05 05 05 05 05 05 05 05 05 05 05 05 05 05 05 05 05 05 05 05 05 05 05 05 05 05 05 05 05 05 05 05
05 05 05 05 05 05 05 05 05 05 05 05 05 05 05 05 05 05 05 05 05 05 05 05 05 05 05 05 05 05 05 05 05 05 05 05 05 05 05 05 05 05 05 05 05 05 05 05 05 05
05 05 05 05 05 05 05 05 05 05 05 05 05 05 05 05 05 05 05 05 05 05 05 05 05 05 05 05 05 05 05 05 05 05 05 05 05 05 05 05 05 05 05 05 05 05 05 05 05 05
05 05 05 05 05 05 05 05 05 05 05 05 05 05 05 05 05 05 05 05 05 05 05 05 05 05 05 05 05 05 05 05 05 05 05 05 05 05 05 05 05 05 05 05 05 05 05 05 05 05
05 05 05 05 05 05 05 05 05 05 05 05 05 05 05 05 05 05 05 05 05 05 05 05 05 05 05 05 05 05 05 05 05 05 05 05 05 05 05 05 05 05 05 05 05 05 05 05 05 05
